22222222222222222
23333333333333332
23222222322222232
23F33333333333F32
23333333P33333332
23333333333333332
23333333333333332
2333333LLL3333332
2N33333L9L33M3N32
2333333LLL3333332
23333333333333332
23333333333333332
23333333333333332
23F33333333333F32
23222222322222232
2N333333333333N32
22222222222222222