222222222222222222222
23N333333333333333N32
232223222232222322232
23F3333333P3333333F32
232223222232222322232
233333333333333333332
233333333LLL333333332
233333G33L9L333333332
233333333LLL333333332
233333333333333333332
232223222232222322232
23F333333333333333F32
2N22232222322223222N2
2333333333N3333333332
222222222222222222222