222222222222222222222
23H333333333333333H32
232223222232222322232
23F3333333P3333333F32
232223222232222322232
233333333333333333332
233333333LLL333333332
233333T33L9L333333332
233333333LLL333333332
233333333333333333332
232223222232222322232
23F333333333333333F32
2H22232222322223222H2
2333333333H3333333332
222222222222222222222