222222222222222222222
222222222000222222222
22H000000000000000H22
2202222220P0222222022
220222222000222222022
220220000000000022022
220220000000000022022
220220000000000022022
220220000000000022022
200000000LLL000000002
200000000L9L000000002
200000000LLL000000002
220220000000000022022
220220000000000022022
220220000000000022022
220220000000000022022
220222222000222222022
2202222220J0222222022
22H000000000000000H22
222222222000222222222
222222222222222222222
