2222222222222222222222222
23H3333333333333333333H32
2322232332333332332322232
23F3333333333333333333F32
2333232332333332332323332
233333333333P333333333332
2323222332333332332223232
2333333333333333333333332
23333333333LLL33333333332
2333333J333L9L33333333332
23333333333LLL33333333332
2333333333333333333333332
2323222332333332332223232
2333333333333333333333332
23H3232332333332332323H32
23F3333333333333333333F32
2322232332333332332322232
2333333333333H33333333332
2222222222222222222222222